11,19,12,18,19,19,19,19,19,19,5,10,10,15,20,
1,2,2,2,2,2,2,2,2,2,2,2,2,2,1,
1,7,7,7,7,7,7,7,7,7,7,7,7,7,1,
1,6,3,6,3,6,3,6,3,6,3,6,3,6,1,
1,6,7,6,7,6,7,6,7,6,7,6,7,6,1,
1,6,3,6,3,6,3,6,3,6,3,6,3,6,1,
1,6,7,6,7,6,7,6,7,6,7,6,7,6,1,
1,6,3,6,3,6,3,6,3,6,3,6,3,6,1,
1,6,7,6,7,6,7,6,7,6,7,6,7,6,1,
1,6,3,6,3,6,3,6,3,6,3,6,3,6,1,
1,6,7,6,7,6,7,6,7,6,7,6,7,6,1,
1,6,3,6,3,6,3,6,3,6,3,6,3,6,1,
1,6,7,6,7,6,7,6,7,6,7,6,7,6,1,
2,2,2,2,2,2,2,2,2,2,2,2,2,2,2